####### ###########################
#         #       #   #           #
# # ##### # ##### # # # # ####### #
# # #   #   #   #   #   # #   #   #
# # # # ##### # ####### # # # # # #
# #   # #     # #     # #   #   # #
# # ### # ##### # ### # # ####### #
# #   # # #     #   # # # #       #
# ### # # # ### ### # # # # # ### #
#     # # #     #   #     # #   # #
# ### # # ### ### # ####### ### # #
#     # # #   #   # #     #   #   #
### ### # # ### # # # ### ### #####
#   #   #   #   #   # #     # #   #
# # # ##### # ##### # # ### # # # #
# # #     # #       # # #   # # # #
# # # ### # ######### # # ### # # #
# # # #   #   #       # #   # # # #
# # # # ##### # ####### ### # # # #
# # #   #   #   #   #       #   # #
# # ##### # ### # # # ########### #
# # #   # #   #   # # #         # #
# # # # # # # ##### # # ####### # #
# # # # # # # #     #   #     #   #
# # # # # # # # ######### ### ### #
# #   #   # # #           #     # #
# ####### # # # ########### ### # #
# #       #   # #           #   # #
# # # ##### ### # ########### ### #
#   #     # #   # #           #   #
### ##### # # # # # ##### ##### ###
#       # # # # # # #     #   #   #
# ##### # # # # # # # # ### # ### #
#       #   #     #   #     #     #
################################# #
