########### ###############
#         #   #           #
#  ### ##  ##   ## ##  ## #
# #           # #     #   #
# # ########### # ##### # #
# #           #   #     # #
#  ### ###  #  ###  ## ## #
#     #     #     # #     #
##### # # ####### # # ### #
#     # # #       #   #   #
#   ##  #   #  ### ###  # #
# # #   # # # #     #   # #
# # # ### # # # ### # ### #
# # #       #     # # #   #
#   #  ### ### ##   #   # #
# # #         #   #   # # #
# # ######### # ####### # #
#           # # #         #
## ### ###  #   #  ###  ###
#       #   #     #   #   #
# # ### # ######### # ### #
# # #     #     #   #     #
#   #  ###  ##  #   ## ####
# #   #   #     # #   #   #
# # ### # ### ### ### # # #
# #     #   #   #   # # # #
#  ### ##   ##  #   #   # #
# #   #   #     # #   # # #
# # # # ##### ### ##### # #
#   #   #     #         # #
## ##  ##  ###  ## ### ## #
#     #   #     #         #
# ### # ### ##### # ##### #
#     #           #       #
### #######################
