# #####################
#               #     #
##  ## ###  ##  #  ## #
#   #   #   #   #   # #
# ### # # ### # ### # #
#     # #     #     # #
## ###  ## ### ###  # #
#       #           # #
# ####### ####### ### #
#       # #       #   #
## ##   #   #  ###  ###
#     # #   #         #
# ##### # ########### #
# #     # #   #   #   #
#   #  ##   #   #   ###
# # # #   # # # #     #
# # # # # # # # ##### #
#     # # # #       # #
## ###  #   ## ###  # #
#         # #       # #
# ### # ### # # ##### #
#     #       #       #
################### ###
