##################################################################################################################### ###########
#   #           #   #           #   #           #       #     # #       #   #   #       #       #   #   #       #       #       #
#   ##  #  ###  #  ##   #  ###  #   #  ##  ##  ### ###  #  ##   #  ###  #  ##   ##  ## ##  ###  #   #  ##  ###  #  ### ##  ### ##
# #   # # # #     #   # # #     # # # # # # #   #       # # #   # #   # #   # #     #   # #   # # #       # # # #   #   # #     #
# ### # # # # ### # ### # ####### # # # # # ### # ####### # # ##### # # # # # # # ### ### ### # # ##### # # # # ### ### # ##### #
# #   # #   #   # #   # #       # #   # # #   # # #   # # # #   #   #   # # # # #   #       # # #     # #   # # #   #   # #     #
#   ##  #  ###  #  ##   ## ###  #  ##   #  ##  ##   #   #   ##  #  ### ##   #   #   ##  #   #   #  ###  ##  #   #   #   #   ##  #
# #     #   #   #     # #       #   #   #           #   # #     #       # #   # # #     # #   # # #     #   #   # #   #     #   #
### ############################### ################# ### ############# ### ################# ####### ##### ############# #######
#     # # #     # # #       # # #       # #     #       #   #   #           #   #       #   #     #     #   #   #       #     # #
#  ##   #   ##  #   #  ###  #   #  ### ##   #  ##  ###  #  ##  ##  ###  #  ###  #   ## ##   #   #   #  ##  ##  ##  ###  #  ##   #
# #   #     # # #   #   #   #   # #     #   #   # #     #   #   #   # # # #     # # #   # # # # #   #   # #   #     # # #   # # #
# ##### # ### # ### # # # # ### # # # # ####### # # ####### # # ### # # # # ####### # # ### # ### ##### # # # # ### # ####### # #
# #   # # #   # #   # # # #     # # # # #     # # # #   #   # # #   #   # #     #   # #     #   # #     # # #   #   #         # #
#   #   #   ##  #  ###  #  ### ##   #  ##  ##   #  ###  #  ###  #   ## ##  ###  #  ##   #  ###  #   ## ##   ##  #  ###  #  ###  #
#   #   # #     #       #       #   #   #   #   #       #       # #     #       #     # #       # #     #   #   #       #       #
############### ##### ######### ##### ### ########### ######### ############# ### ################### ###########################
# #     #       #       #   #   # #     #       #   #   #   #   #   #   #   #   #       #       #       #       #     # #   # # #
#   ## ##  ### ##  ###  ##  #   #   #  ### ##   #   #   #   ##  #  ##   #  ##   #  ###  ##  ##  #  ### ##  ###  #  ##   ##  #   #
# #     #       #     # #     # #   #   # #   # # #   # # #   # # #   # # #   # # #   # #   #   # #     #     # # # #       #   #
# ### # # ######### ### # ####### ##### # # ##### ##### # ### # # # # ### # ##### ### # # ####### ### # ##### # # # ##### # ### #
# #   #   #     #   #   #   #   # #     # #           #     #   #   #   # #     #   #       #   #   # # #   # #       # # #   # #
#  ###  #   ##  #  ##   ##  #   #  ##  ##  ###  ## ###  #  ### ##  ###  #   ##  #   ##  #   #   #   #   ##  #   ## ##   #  ###  #
#       #   #   # #   # #     # #   #   #       #       #       # #         #   # #   # # #   # # #   # #     # #       #       #
# ######################### ########### ################### ########### ############################### ##### ################# #
#       #     # #   #   #   #       #   #       #   #   #           #         # # #   # #       #       # # #   #   #   #   #   #
##  ##  #  ##   ##  #   ##  #   #   #   #  ###  #   #   #  ###  #   #   ## ##   #  ##   #  ##  ##  ###  #   #   #   ##  #  ##   #
#   #   #   #   #   # # #   # # # #   # # #   #   #   # # # #   # # # # #   # #     #     # #   # #   # #   # # # # #   #     # #
# ######### # ### # # # # ### # # ##### # # # # # ####### # # ### # # # # # # # # # ### # # ### # # # # # ### # # # # ##### ### #
#           #   # # # #   #   # # #   # # # # # # #   # # #     # #   # # #     # #     # # #   #   # #   #   # # # #   #   #   #
## ##   #  ###  #  ###  #  ###  #  ##   ##  ##  #   #   #  ### ##  ###  #  ### ##  ##  ##   #   ## ##   #   ##  #   #   #  ##  ##
#     # #     #         #       #   #           #   #   #       # #     #       #   #   # #   # #     # #   #   # #   #     #   #
############### ####################################################################################################### #########
#   #   #     # # #     #   #   # #     #   #   #               #               #   #   #       # #     # #   # #     # #   #   #
#   #  ##  ##   #   ##  #   #   #  ###  #   #  ### ###  ## ##   #  ### ##  ##  ##   ##  #  ##   #   ##  #   #   ## ##   ##  #  ##
# #     # #   # # #   # # # # # #     # # # #         # #     # #       # # #   # # #     # # # #   #   # # #   #       #   #   #
# ##### # # # # # ##### # # # # # ### # # ##### ##### # # ### ######### # # ### # # # # # # # ####### ### # ### # # ##### ### # #
# #   # # # # # #     # # # # # # #   # # #     #       # # #   #     # # #   # # #   # # # #   #   #     # #   # #   #     # # #
##  #   #   #   #   ##  #   #  ##  ###  #   ## ##  ### ##   ##  ##  #   #   #   #   ## ##   ##  ##  ##  #  ##  ##  ###  ##  ##  #
#   #   # # #     #     # #     #               #       # #     #   #   # # #   # #     # #     #       #               #       #
##### ### ########### ##### ##### ####################### ################# ##### ######### ################################# ###
#       # #     # #     #     # #           #   #     # #   #   # #   # # #     #   #   #       # #     #         #     #       #
#  ###  #   #  ##   #   #  ##   #  ###  #   #   #  ##   ##  #   #   #   #   ##  #   ##  ##  ##  #   ## ##  ###  #   ##  #  ### ##
# #     #   #   # # # # # #     #   # # # #   # #   #   #   # # #   #   #     # # #   # #   #   #   #   #     # # #   #         #
### ######### # # # # # # ##### ### # # ####### ### # ### # # # # ### ####### # # ### # # ### ### # ### ##### # # ##### ####### #
#   #   #   # # #   # #   #   # #   #   #       # # # # # #   # # #     #   # #   #   # # #   # # #         # # #   #   #     # #
#   #   #  ###  #  ##   #   #   ## ##  ##  ### ##  ##   #  ###  #   ## ##  ##   #   ##  #   ##  #  ### ##  ###  #   ##  #  ###  #
# #   # #       # #   # #   # # #       #       #             #   #           # # #     # #     #       #       # #     #       #
### ######### ######### ############################# ############### ##################### ########### ######### ###############
#     # #   #   # #   # # # #   #       #       #     # #       #       # # #         # #   #   #   #   #   #   #               #
#  ##   #   ##  #   ##  #   #   #  ###  #   ## ### ##   #  ###  ## ##  ##   #   #  ##   #  ##  ##  ###  ##  #   ##  ##  #  ### ##
#   #   # #     # #       #   # #   #   # # #   #     #     # # #       #   # # # # # #     #   #       #   # # #     # #   #   #
### ### # ##### # ##### # # ### ### # ##### ### # ##### ### # # # ##### ### # # # # # # ### # ### ####### ### # # ### # ### # # #
#   # # #     # #   #   # #   # #   # #     #   # #     #     # #   # # #   # # #   # # #   #   #     # #     # #   # # # #   # #
#  ##  ### ###  #   #  ##  ###  #  ##   #  ##  ##   #  ##  ###  ##  #   #  ##   #   ##  #  ###  ## ##   #  ###  ## ##   #  ###  #
#       #       # #     #       #   #   #       #   #   # #     #   #   #     # # #     #       #       # #     #     # #       #
### ####################### ####### ######################### ### ############################# ### ######### ########### #######
# #     #   # # # #     #       #     # #   #   #   #         # #   #   #   #           #     # #       #   #   #   # # #   #   #
#   ## ##   #   #   ##  #  ###  #  ##   #  ##  ##  ###  #  ##   ##  #   #  ###  #  ###  #  ##   #  ### ##   ##  #   #   #   ##  #
# #       #   #     #   # #   # # #   # #               #   # # #     #       # # #   # # #     #   #   # #     # #   # # # #   #
# ### ### ##### # ### ### # ####### # # # ##### # ########### # # # ### ##### # # # # # # ######### # ### ##### # ##### # # # ###
#     # # #     # # #     #     # # # # # # #   # #     #       # # # # #     # # # #   # #     # # #   # #   # #     # # # #   #
#   ##  #   ##  #   ##  #  ###  #   #   #   #   #   ##  #  ### ##   #   #  ###  #  ### ##  ###  #   ##  #   ##  ##  #   #   ##  #
# #     #   #   #     # #       #   #       # # #   #   #       # #   # #       #       #       #       #   #       #     #     #
########### ############################# ############################################# ######### ###############################
#   #   #   #   #   #   #   #   #   #   #     # # #   # # #     #     #   # #   #       #       #   #           #       # #   # #
#  ##   #  ##  ###  #   #   #   #  ##   #  ##   #   ##  #   ##  #  ##   #   ##  #  ##  ##  ###  #   ##  #  ### ##  ###  #   #   #
#   # # # #     # #   # # # # # # #   # #   #           # #   # # #   # # #   # # #   # #   # # # #   # # #           # # # #   #
# # # ### # ### # ##### # # # ### # ### ### ##### ##### # # # # # ### # # # # # # # ### ##### # # ### # # ##### ####### # ##### #
# #   # # # #   # #   # # # #   #     #   #     #     # #   # # #   #   # # #   # #   # #     # # # #   # #   # # #       #     #
#  ###  #   #   #   #   #   ##  ## ###  #  ###  ## ##   ## ##   #   ##  #   #  ##  ##   #   ##  #   ## ##   #   #   ##  #   #  ##
#       #   # #     #     #     #       #       #     #       # # # #   #   #   #   #     #     #       #   #   #   #   #   #   #
# ########### ################# ### ##################################### ############# # ########### ####################### ###
# #     #       #     # # #   #       # # #       #     #   #   #   #           #   #   # # #   #       #       #       #   #   #
#   #   #  ###  ## ##   #  ##   #  ##   #   ##  #   ##  #  ##   #  ##   #  ### ##   #  ##   #   ## ###  ## ###  #  ### ##   ##  #
# # # #   # # # #     # #     # # # # # #   #   #     #     # # #     # # #     # #     #   # # #     # #     # #   #   # # #   #
# # # ### # # # # # ### # ##### # # # # # ### ######### # # # ######### # ### # # ##### ### # # # ### # ### ### ### # # # ### ###
#   #   # #   # # #   # # #     # #     # #   # # #   # # # #   #   #   #   # # # # #   #   # # # #   #   # #   #   # #     #   #
#  ###  #   ##  #  ##   #   ##  #  ###  #   ##  #   #   #   #   #   #  ###  ##  #   #   #  ###  #   ##  #   #   #  ##   #   ##  #
#   #   # #     #   #   #   #   #     # # #     #   #   # #   # # #     #       # #   # #       # #     #     # #     # # #     #
##### ############### ### ############# ####### ##### ######### ####### ##### ##### ##### ############### ############# #########
#   #   # # #   #     # #       #       #   #   #       #   #   #       #       # # #   # #   # # #     # #     # # #   #     # #
#  ##   #   #   ##  #   ## ###  ## ###  #   #   ## ###  #   #  ##  ###  #  ##  ##   #   #   #   #   ##  #   ##  #   #   #  ##   #
# # # # #     # #   #   #   #   #   # # # # # # #     # # #     #   # # # # #   #     # #   #   #   #   #   #   # # # # # #     #
# # # # ####### # ##### # ### ### # # # ### # ### ### # # ######### # # # # ### ####### # ##### # ####### ### ### # # # # # #####
#   # # #       # # # # #   #   # #   #     #   #   # # #     # #   #   # #   # #     # # #     # #     #   #   # #   # # #     #
#   ##  #   ## ##   #   #   ##  #  ###  #  ###  ##  #   ##  #   #   ##  #   #   #   ##  #  ### ##  ###  ##  ##  #  ###  #  ###  #
# #       #         #   # #     #       #       #   #   #   #   # #   # # # #   # #     #       #           #   #       #   #   #
################# ##################################### ### ########### ##### ############### ####################### ######### #
# #             #       #       #   #     #   # #       #   #   #   #   #   #   #       # #     #   #   #       # #     #   #   #
#   ##  ##  ## ##  ### ##  ### ##   ##  #   #   ##  ##  #  ##  ###  #   #  ##   #  ##   #   ## ###  ##  #  ###  #  ###  #  ##   #
# # #   #   #   #   #   # #     # #   # #   #   #   # # #       #   # # #     # # # # # # #     #   #   # #   # #     # #     # #
# # # ### ### # ### # ### # ### # ### # # ####### ### # ##### # # # ### ### ### # # # ### ##### # ### ### # # # ##### # ##### ###
#   #   # #   # #   #   # # #   #   # # #       # #   # #   # # # #   # # # # # #   #   #     # # #   #   # #     #   # #     # #
#  ##   #   #   #   #   #   #   ## ##   ## ###  #   #   #  ###  #  ##   #   #   #  ### ##   ##  #   #   #   ## ##   ##  #  ###  #
# #   # #   # #   #   #     # # #       #           # # #       #   #   #   #             #     #   #   # #     #               #
################################################################################################################# ###############
#     # #               #     # #       #     #     #   # #   # #       #     # # #     # #     # #   # #           #   # #   # #
#  ###  #  ### ##  ###  #  ###  #  ##  ##  ##   ##  #   #   #   ## ##  ##  ##   #   #   #  ##   #   ##  #  ###  #   #   #   ##  #
#     # # #     # # # # #     # #   #   # #   # #   # #     #   #   #     # #   #   # # # #   # # #     # #   # # #   # #   #   #
##### # # # ### # # # # ### # # # ##### ### ### # ### ### ##### # ##### # # ### ### # ### # ##### # ### # # ### # ### # # ### ###
# #   #   #   # #   #   # # #     #   #     #   # #     #     # #     # # # # # # # #   #   #   # # #     #   # # # # # # #     #
#   ##  #  ###  #  ### ##   ## ###  #   #  ###  #   ##  ##  #  ##  ##   #   #   #  ###  #   ##  #  ##  ##  ##   #   #   #  ###  #
#       #       #       #       #   #   #       #   #   #   #   #   #   #   #           # #     #       #   #   # #   #         #
##### ################# ### ##################### ######### ######### ############# ##### ########### ####################### ###
#       #   #   # # #   # #     # #   # #     # #   #   #   #   #   #   #   #           # #     #     # #     #         #       #
#  ###  #   ##  #   #   #  ###  #  ##   #   ##  #   #  ##  ##   #   #   #   ##  ## ###  #  ##   ##  #   ## ##   #  ### ##  ###  #
#     # # #       #   # # #     # #     # #   # # #     # #   # # #   # # #   # #       #     # # # #   #       # #     #   # # #
### ### # ####### ##### # # # ### # ### ##### # # ##### # # ### # ### # # ### # # # ####### ### # # ### # ##### # # ### ### # # #
# #   # #       #     #     #   # # # # #     # #     # #   #   # # # # # # #   # #       #   # # # #   #     # #     # #   #   #
#  ##   #  ###  #  ##   ## ##   #   #   #  ###  ## ###  #  ### ##   #   #   ##  #  ###  #  ##   #  ##  ### ##   ## ###  #  ### ##
#     # #   #   #   #   #     # #   #           #       #       # #   # #   #   #     # #     # #       #     # #       #       #
####### ############################### ### ########### ### ########### ####### ############################### ### ##### #######
#     # #       #       # #   # #       #   #   #       #   #   #   #   #   #   #               #   #   #   #   #       #   #   #
#  ##   ## ###  #  ###  #   #   ##  ##  #  ##   #  ###  #  ##   #   #   #   ##  ##  ## ##   ##  ##  #   ##  ##  #  ###  #   #   #
# #   # #       #     # #   #   #   #   #     # # #   # #     # # # # # # # #   #       # # # # #   # # # #   # #     # # #   # #
### ### # ######### ### # ### ### ### ######### # ### ######### ### # ### ### ### ##### ### # # # ### ### # # # ##### ######### #
#     # #       # #   #   # #   # # # # # #   # #   #   #   #           # #     #     # #   # # #     #   # # # #       #   #   #
#  ##   #  ###  #  ##  ##   ##  #   #   #   #   #   ##  #  ##  ##  ###  #   ##  ## ###  #  ##   ##  #   #   #   #  ### ##   #  ##
#   #   #   #           #   #   # #     #   #   # #     #       # #     #   #   #       #     # #   #   #   #   #       # #     #
##### ##### ########### ############# ############# ######### ### ############################# # ############################# #
#   #   #       #       # #     #       #           #   #   #   #     #         # #     #       # #     #   #   #   #   #       #
#   #   ## ###  #  ##   #  ###  #  ##  ### ###  #   #  ##  ##   ##  #   #  ###  #   ##  #  ###  #   ## ##   #   ##  #   #  ### ##
# # # # #   #   # #   # #     # # #         #   # # #   #     # #   #   # #   # #   #   # #     # #       #   # #   # # #   #   #
# ##### # ### ### # ######### # ### ### ### # ### ### # ####### ####### # # ### ### ##### ####### ##### # ####### ##### ### # # #
#   #           # #     #       #   #   #   #   # #   # #     # #   #   # #   # # #   # #     # #     # # #           # #   # # #
##  #   ## ##   #  ###  #  ### ##  ##  ##  ###  #  ###  #  ##   #  ##  ##  ##   #  ##   ## ##   #  ##   #   #   #  ##   #   #   #
#     # #     # # #             #   #   #       #       #   #   #       #     #                     #   #   # # #   #     #   # #
######### #######################################################################################################################
