######### #######
#   #   #   #   #
#   #   ##  #   #
# # # #     # # #
# # # ####### # #
# #         #   #
#  ### ###  #  ##
#         #     #
####### # ##### #
#       #       #
#  ### ### ###  #
# #   #       # #
# # # # ##### # #
#   # #     # # #
#  ##  ###  #   #
#           #   #
######### #######
