########### ###################
#   #   #   #           #     #
# # # # # # # ####### # # # # #
# #   # # # #       # # # # # #
# ##### # # ####### # # # # # #
#       # # #     # #   # # # #
# ##### # # # ### # ##### # # #
# #   # # # #   #       #   # #
# # # # # # ### ####### ##### #
# # # # # #   # #       #     #
# # # # # ### # # # ##### #####
# #   #       #   #   #       #
# ### ### ########### # # ### #
#       # #             # #   #
# ##### # # ##### ####### # # #
# #     # # #   #         # # #
# # ### # # # # ### ####### # #
# #   #   #   # #   #         #
# ### ####### # # ### #########
#   # #     #   # #           #
# # # # ### ##### # # ####### #
# #     #       #   # #       #
# ####### # ### ##### # #######
#     #   #   #       #   #   #
### # # ##### # ##### ### # # #
#   # # #       #     #   # # #
# ### # # ####### ##### ### # #
#     #       #   #     #   # #
# ########### # ### # ### ### #
#             #     #         #
##### #########################
